"filename", "language", "Java", "Properties", "source.markdown.math", "XML", "Batch", "comment", "blank", "total"
"/Users/season/IdeaProjects/TradeExperment/.mvn/wrapper/MavenWrapperDownloader.java", "Java", 76, 0, 0, 0, 0, 31, 12, 119
"/Users/season/IdeaProjects/TradeExperment/.mvn/wrapper/maven-wrapper.properties", "Properties", 0, 2, 0, 0, 0, 0, 1, 3
"/Users/season/IdeaProjects/TradeExperment/README.md", "source.markdown.math", 0, 0, 2, 0, 0, 0, 3, 5
"/Users/season/IdeaProjects/TradeExperment/mvnw.cmd", "Batch", 0, 0, 0, 0, 96, 51, 36, 183
"/Users/season/IdeaProjects/TradeExperment/pom.xml", "XML", 0, 0, 0, 90, 0, 1, 9, 100
"/Users/season/IdeaProjects/TradeExperment/src/main/java/com/ccut/tradeexperment/TradeExpermentApplication.java", "Java", 11, 0, 0, 0, 0, 0, 5, 16
"/Users/season/IdeaProjects/TradeExperment/src/main/java/com/ccut/tradeexperment/controller/CandidateController.java", "Java", 132, 0, 0, 0, 0, 5, 33, 170
"/Users/season/IdeaProjects/TradeExperment/src/main/java/com/ccut/tradeexperment/controller/FundController.java", "Java", 59, 0, 0, 0, 0, 5, 19, 83
"/Users/season/IdeaProjects/TradeExperment/src/main/java/com/ccut/tradeexperment/mapper/CandidateMapper.java", "Java", 8, 0, 0, 0, 0, 4, 4, 16
"/Users/season/IdeaProjects/TradeExperment/src/main/java/com/ccut/tradeexperment/mapper/FundMapper.java", "Java", 8, 0, 0, 0, 0, 0, 4, 12
"/Users/season/IdeaProjects/TradeExperment/src/main/java/com/ccut/tradeexperment/pojo/Candidate.java", "Java", 15, 0, 0, 0, 0, 3, 5, 23
"/Users/season/IdeaProjects/TradeExperment/src/main/java/com/ccut/tradeexperment/pojo/Fund.java", "Java", 13, 0, 0, 0, 0, 4, 3, 20
"/Users/season/IdeaProjects/TradeExperment/src/main/java/com/ccut/tradeexperment/pojo/TradePolicy.java", "Java", 13, 0, 0, 0, 0, 3, 3, 19
"/Users/season/IdeaProjects/TradeExperment/src/main/java/com/ccut/tradeexperment/service/CandidateDaoImpl.java", "Java", 57, 0, 0, 0, 0, 0, 9, 66
"/Users/season/IdeaProjects/TradeExperment/src/main/java/com/ccut/tradeexperment/service/FundDaoImpl.java", "Java", 65, 0, 0, 0, 0, 3, 9, 77
"/Users/season/IdeaProjects/TradeExperment/src/main/java/com/ccut/tradeexperment/util/CalculateTools.java", "Java", 11, 0, 0, 0, 0, 3, 4, 18
"/Users/season/IdeaProjects/TradeExperment/src/main/java/com/ccut/tradeexperment/util/InitializeTools.java", "Java", 27, 0, 0, 0, 0, 4, 9, 40
"/Users/season/IdeaProjects/TradeExperment/src/main/java/com/ccut/tradeexperment/util/ValidateTools.java", "Java", 20, 0, 0, 0, 0, 3, 2, 25
"/Users/season/IdeaProjects/TradeExperment/src/main/resources/application.properties", "Properties", 0, 7, 0, 0, 0, 6, 3, 16
"/Users/season/IdeaProjects/TradeExperment/src/test/java/com/ccut/tradeexperment/TradeExpermentApplicationTests.java", "Java", 9, 0, 0, 0, 0, 0, 5, 14
"Total", "-", 524, 9, 2, 90, 96, 126, 178, 1025